CV_1,0,0,-,>,-
CV_2,1,0,-,>,-
CV_3,2,0,-,>,-
CV_4,3,0,-,>,-
CV_5,2,1,-,-,-
CV_6,3,1,-,-,-
CV_7,4,0,b,>,-
CV_8,4,1,b,-,-
CV_9,3,2,-,-,-
CV_10,4,2,b,-,-
CV_11,5,0,-,>,-
CV_12,5,1,-,-,*
CV_13,5,2,-,-,*