1,0,0,-,-,-
2,1,0,-,-,-
3,2,0,-,-,-
4,3,0,-,-,-
5,4,0,-,-,-
6,5,0,-,-,-
7,0,1,-,-,-
8,1,1,-,-,-
9,2,1,-,-,-
10,3,1,-,-,-
11,4,1,-,-,-
12,5,1,-,-,-